5 80 2
200 60
200 60
 1 -10 -10 0 12 1 2 1 2
 2 -10   0 0 12 1 2 1 2
 3 -10  10 0 12 1 2 1 2
 4   0 -10 0 12 1 2 1 2
 5   0  10 0 12 1 2 1 2
 6  10 -10 0 12 1 2 1 2
 7  10   0 0 12 1 2 1 2
 8  10  10 0 12 1 2 1 2
 9 -20 -20 0  8 1 2 1 2
10 -20   0 0  8 1 2 1 2
11 -20  20 0  8 1 2 1 2
12   0 -20 0  8 1 2 1 2
13   0  20 0  8 1 2 1 2
14  20 -20 0  8 1 2 1 2
15  20   0 0  8 1 2 1 2
16  20  20 0  8 1 2 1 2
17 -30 -30 0  4 1 2 1 2
18 -30   0 0  4 1 2 1 2
19 -30  30 0  4 1 2 1 2
20   0 -30 0  4 1 2 1 2
21   0  30 0  4 1 2 1 2
22  30 -30 0  4 1 2 1 2
23  30   0 0  4 1 2 1 2
24  30  30 0  4 1 2 1 2
25 -40 -40 0  2 1 2 1 2
26 -40   0 0  2 1 2 1 2
27 -40  40 0  2 1 2 1 2
28   0 -40 0  2 1 2 1 2
29   0  40 0  2 1 2 1 2
30  40 -40 0  2 1 2 1 2
31  40   0 0  2 1 2 1 2
32  40  40 0  2 1 2 1 2
33 -50 -50 0  1 1 2 1 2
34 -50   0 0  1 1 2 1 2
35 -50  50 0  1 1 2 1 2
36   0 -50 0  1 1 2 1 2
37   0  50 0  1 1 2 1 2
38  50 -50 0  1 1 2 1 2
39  50   0 0  1 1 2 1 2
40  50  50 0  1 1 2 1 2
41 100 -10 0 12 1 2 1 2
42 100   0 0 12 1 2 1 2
43 100  10 0 12 1 2 1 2
44 110 -10 0 12 1 2 1 2
45 110  10 0 12 1 2 1 2
46 120 -10 0 12 1 2 1 2
47 120   0 0 12 1 2 1 2
48 120  10 0 12 1 2 1 2
49  90 -20 0  8 1 2 1 2
50  90   0 0  8 1 2 1 2
51  90  20 0  8 1 2 1 2
52 110 -20 0  8 1 2 1 2
53 110  20 0  8 1 2 1 2
54 130 -20 0  8 1 2 1 2
55 130   0 0  8 1 2 1 2
56 130  20 0  8 1 2 1 2
57  80 -30 0  4 1 2 1 2
58  80   0 0  4 1 2 1 2
59  80  30 0  4 1 2 1 2
60 110 -30 0  4 1 2 1 2
61 110  30 0  4 1 2 1 2
62 140 -30 0  4 1 2 1 2
63 140   0 0  4 1 2 1 2
64 140  30 0  4 1 2 1 2
65  70 -40 0  2 1 2 1 2
66  70   0 0  2 1 2 1 2
67  70  40 0  2 1 2 1 2
68 110 -40 0  2 1 2 1 2
69 110  40 0  2 1 2 1 2
70 150 -40 0  2 1 2 1 2
71 150   0 0  2 1 2 1 2
72 150  40 0  2 1 2 1 2
73  60 -50 0  1 1 2 1 2
74  60   0 0  1 1 2 1 2
75  60  50 0  1 1 2 1 2
76 110 -50 0  1 1 2 1 2
77 110  50 0  1 1 2 1 2
78 160 -50 0  1 1 2 1 2
79 160   0 0  1 1 2 1 2
80 160  50 0  1 1 2 1 2
81   0   0 0  0 0 0
82 110   0 0  0 0 0